________
____*___
__S_*_E_
____*___
________
________