________
____*___
__S_*_E_
____***_
________
________